%%%%%%%%%%%
%.P.  G   %
% %. %% . %
% %% G%%. %
% .  . .  %
%%%%%%%%%%%
