%%%%%%%%%%%%%%%%%%%%%%%%%%%%%%%%
%G           P               G.%
%%%%%%%%%%%%%%%%%%%%%%%%%%%%%%%%