%%%%%%%%%%%%%%%%%%%%%%%%%%%%%
%        .                  %
%                           %
%     .       .             %
%         o                 %
%P o       G   ..           %
%       .                   %
%%%%%%%%%%%%%%%%%%%%%%%%%%%%%